0 s MODULESPEAKER AcceptCommand() 20	Выполнение действия - Поставлена пауза
2 ms MODULESPEAKER AcceptCommand() 16	Выполнение действия - Поставлена пауза
4 ms MODULESPEAKER AcceptCommand() 12	Выполнение действия - Поставлена пауза
6 ms MODULESPEAKER AcceptCommand() 9	Выполнение действия - Снята пауза
8 ms MODULESPEAKER AcceptCommand() 16	Выполнение действия - Поставлена пауза
10 ms MODULESPEAKER AcceptCommand() 13	Выполнение действия - Снята пауза
12 ms MODULESPEAKER AcceptCommand() 17	Выполнение действия - Снята пауза
14 ms MODULESPEAKER AcceptCommand() 19	Выполнение действия - Громкость убавлена
16 ms MODULESPEAKER AcceptCommand() 15	Выполнение действия - Громкость убавлена
18 ms MODULESPEAKER AcceptCommand() 11	Выполнение действия - Громкость убавлена
20 ms MODULESPEAKER AcceptCommand() 17	Выполнение действия - Снята пауза
22 ms MODULESPEAKER AcceptCommand() 18	Выполнение действия - Громкость прибавлена
24 ms MODULESPEAKER AcceptCommand() 12	Выполнение действия - Поставлена пауза
26 ms MODULESPEAKER AcceptCommand() 18	Выполнение действия - Громкость прибавлена
28 ms MODULESPEAKER AcceptCommand() 10	Выполнение действия - Громкость прибавлена
30 ms MODULESPEAKER AcceptCommand() 15	Выполнение действия - Громкость убавлена
32 ms MODULESPEAKER AcceptCommand() 12	Выполнение действия - Поставлена пауза
34 ms MODULESPEAKER AcceptCommand() 21	Выполнение действия - Снята пауза
36 ms MODULESPEAKER AcceptCommand() 10	Выполнение действия - Громкость прибавлена
38 ms MODULESPEAKER AcceptCommand() 14	Выполнение действия - Громкость прибавлена
40 ms MODULESPEAKER AcceptCommand() 9	Выполнение действия - Снята пауза
42 ms MODULESPEAKER AcceptCommand() 15	Выполнение действия - Громкость убавлена
44 ms MODULESPEAKER AcceptCommand() 17	Выполнение действия - Снята пауза
46 ms MODULESPEAKER AcceptCommand() 14	Выполнение действия - Громкость прибавлена
48 ms MODULESPEAKER AcceptCommand() 15	Выполнение действия - Громкость убавлена
50 ms MODULESPEAKER AcceptCommand() 14	Выполнение действия - Громкость прибавлена
52 ms MODULESPEAKER AcceptCommand() 18	Выполнение действия - Громкость прибавлена
54 ms MODULESPEAKER AcceptCommand() 14	Выполнение действия - Громкость прибавлена
56 ms MODULESPEAKER AcceptCommand() 21	Выполнение действия - Снята пауза
58 ms MODULESPEAKER AcceptCommand() 11	Выполнение действия - Громкость убавлена
60 ms MODULESPEAKER AcceptCommand() 15	Выполнение действия - Громкость убавлена
62 ms MODULESPEAKER AcceptCommand() 16	Выполнение действия - Поставлена пауза
64 ms MODULESPEAKER AcceptCommand() 11	Выполнение действия - Громкость убавлена
66 ms MODULESPEAKER AcceptCommand() 13	Выполнение действия - Снята пауза
68 ms MODULESPEAKER AcceptCommand() 12	Выполнение действия - Поставлена пауза
70 ms MODULESPEAKER AcceptCommand() 19	Выполнение действия - Громкость убавлена
72 ms MODULESPEAKER AcceptCommand() 20	Выполнение действия - Поставлена пауза
74 ms MODULESPEAKER AcceptCommand() 16	Выполнение действия - Поставлена пауза
76 ms MODULESPEAKER AcceptCommand() 8	Выполнение действия - Поставлена пауза
78 ms MODULESPEAKER AcceptCommand() 18	Выполнение действия - Громкость прибавлена
80 ms MODULESPEAKER AcceptCommand() 17	Выполнение действия - Снята пауза
82 ms MODULESPEAKER AcceptCommand() 11	Выполнение действия - Громкость убавлена
84 ms MODULESPEAKER AcceptCommand() 17	Выполнение действия - Снята пауза
86 ms MODULESPEAKER AcceptCommand() 14	Выполнение действия - Громкость прибавлена
88 ms MODULESPEAKER AcceptCommand() 14	Выполнение действия - Громкость прибавлена
90 ms MODULESPEAKER AcceptCommand() 15	Выполнение действия - Громкость убавлена
92 ms MODULESPEAKER AcceptCommand() 13	Выполнение действия - Снята пауза
94 ms MODULESPEAKER AcceptCommand() 19	Выполнение действия - Громкость убавлена
96 ms MODULESPEAKER AcceptCommand() 18	Выполнение действия - Громкость прибавлена
98 ms MODULESPEAKER AcceptCommand() 13	Выполнение действия - Снята пауза
100 ms MODULESPEAKER AcceptCommand() 14	Выполнение действия - Громкость прибавлена
102 ms MODULESPEAKER AcceptCommand() 16	Выполнение действия - Поставлена пауза
104 ms MODULESPEAKER AcceptCommand() 17	Выполнение действия - Снята пауза
106 ms MODULESPEAKER AcceptCommand() 7	Выполнение действия - Громкость убавлена
108 ms MODULESPEAKER AcceptCommand() 10	Выполнение действия - Громкость прибавлена
110 ms MODULESPEAKER AcceptCommand() 13	Выполнение действия - Снята пауза
112 ms MODULESPEAKER AcceptCommand() 18	Выполнение действия - Громкость прибавлена
114 ms MODULESPEAKER AcceptCommand() 17	Выполнение действия - Снята пауза
116 ms MODULESPEAKER AcceptCommand() 14	Выполнение действия - Громкость прибавлена
118 ms MODULESPEAKER AcceptCommand() 15	Выполнение действия - Громкость убавлена
120 ms MODULESPEAKER AcceptCommand() 19	Выполнение действия - Громкость убавлена
122 ms MODULESPEAKER AcceptCommand() 11	Выполнение действия - Громкость убавлена
124 ms MODULESPEAKER AcceptCommand() 11	Выполнение действия - Громкость убавлена
126 ms MODULESPEAKER AcceptCommand() 17	Выполнение действия - Снята пауза
128 ms MODULESPEAKER AcceptCommand() 16	Выполнение действия - Поставлена пауза
130 ms MODULESPEAKER AcceptCommand() 17	Выполнение действия - Снята пауза
132 ms MODULESPEAKER AcceptCommand() 11	Выполнение действия - Громкость убавлена
134 ms MODULESPEAKER AcceptCommand() 15	Выполнение действия - Громкость убавлена
136 ms MODULESPEAKER AcceptCommand() 14	Выполнение действия - Громкость прибавлена
138 ms MODULESPEAKER AcceptCommand() 18	Выполнение действия - Громкость прибавлена
140 ms MODULESPEAKER AcceptCommand() 17	Выполнение действия - Снята пауза
142 ms MODULESPEAKER AcceptCommand() 17	Выполнение действия - Снята пауза
144 ms MODULESPEAKER AcceptCommand() 16	Выполнение действия - Поставлена пауза
146 ms MODULESPEAKER AcceptCommand() 14	Выполнение действия - Громкость прибавлена
148 ms MODULESPEAKER AcceptCommand() 23	Выполнение действия - Громкость убавлена
150 ms MODULESPEAKER AcceptCommand() 13	Выполнение действия - Снята пауза
152 ms MODULESPEAKER AcceptCommand() 15	Выполнение действия - Громкость убавлена
154 ms MODULESPEAKER AcceptCommand() 16	Выполнение действия - Поставлена пауза
156 ms MODULESPEAKER AcceptCommand() 10	Выполнение действия - Громкость прибавлена
158 ms MODULESPEAKER AcceptCommand() 17	Выполнение действия - Снята пауза
160 ms MODULESPEAKER AcceptCommand() 24	Выполнение действия - Поставлена пауза
162 ms MODULESPEAKER AcceptCommand() 20	Выполнение действия - Поставлена пауза
164 ms MODULESPEAKER AcceptCommand() 13	Выполнение действия - Снята пауза
166 ms MODULESPEAKER AcceptCommand() 19	Выполнение действия - Громкость убавлена
168 ms MODULESPEAKER AcceptCommand() 17	Выполнение действия - Снята пауза
170 ms MODULESPEAKER AcceptCommand() 11	Выполнение действия - Громкость убавлена
172 ms MODULESPEAKER AcceptCommand() 17	Выполнение действия - Снята пауза
174 ms MODULESPEAKER AcceptCommand() 15	Выполнение действия - Громкость убавлена
176 ms MODULESPEAKER AcceptCommand() 16	Выполнение действия - Поставлена пауза
178 ms MODULESPEAKER AcceptCommand() 15	Выполнение действия - Громкость убавлена
180 ms MODULESPEAKER AcceptCommand() 7	Выполнение действия - Громкость убавлена
182 ms MODULESPEAKER AcceptCommand() 17	Выполнение действия - Снята пауза
184 ms MODULESPEAKER AcceptCommand() 18	Выполнение действия - Громкость прибавлена
186 ms MODULESPEAKER AcceptCommand() 19	Выполнение действия - Громкость убавлена
188 ms MODULESPEAKER AcceptCommand() 14	Выполнение действия - Громкость прибавлена
190 ms MODULESPEAKER AcceptCommand() 12	Выполнение действия - Поставлена пауза
192 ms MODULESPEAKER AcceptCommand() 11	Выполнение действия - Громкость убавлена
194 ms MODULESPEAKER AcceptCommand() 14	Выполнение действия - Громкость прибавлена
196 ms MODULESPEAKER AcceptCommand() 12	Выполнение действия - Поставлена пауза
198 ms MODULESPEAKER AcceptCommand() 8	Выполнение действия - Поставлена пауза
